98;98;0;0;0;0
00000000000000000000000000000000000000000000000000000000000000000000000000000000000000000000000000
00000000000000000000000000000000000000000000000000000000000000000000000000000000000000000000000000
00000000000000000000000000000000000000001111111111111111000000000000000000000000000000000000000000
00000000000000000000000000000000000000001000000030000001000000000000000000000000000000000000000000
00000000000000000000000000000000000000001000000000000001000000000000000000000000000000000000000000
00000000000000000000000000000000000000001001111111111001000000000000000000000000000000000000000000
00000000000000000000000000000000000000001001000000001001000000000000000000000000000000000000000000
00000000000000000000000000000000000000001001000000001001000000000000000000000000000000000000000000
00000000000000000000000000000000000000001001000000001001000000000000000000000000000000000000000000
00000000000000000000000000000000000000001001000000001001000000000000000000000000000000000000000000
00000000000000000000000000000000000000001001000000001001000000000000000000000000000000000000000000
00000000000000000000000000000001111111111001111111111001111111111000000000000000000000000000000000
00000000000000000000000000000001000000000000000000000000000000001000000000000000000000000000000000
00000000000000000000000000000001000000000000000000000000000000001000000000000000000000000000000000
00000000000000000000000000000001001111111001111001111001111111001000000000000000000000000000000000
00000000000000000000000000000001001000001001001001001001000001001000000000000000000000000000000000
00000000000000000000000000000001001000001001001001001001000001001000000000000000000000000000000000
00000000000000000000000000000001001000001001001001001001000001001000000000000000000000000000000000
00000000000000000000000000000001001000001001001001001001000001001000000000000000000000000000000000
00000000000000000000000000000001001000001001001001001001000001001000000000000000000000000000000000
00000000000000000000000000000001001000001001111001111001000001001000000000000000000000000000000000
00000000000000000000000000000001001000001000000000000001000001001000000000000000000000000000000000
00000000000000000000000000000001001000001000000000000001000001001000000000000000000000000000000000
00000000000000000000000000000001001000001001111111111001000001001000000000000000000000000000000000
00000000000000000000000000000001001000001001000000001001000001001000000000000000000000000000000000
00000000000000000000000000000001001000001001000000001001000001001000000000000000000000000000000000
00000000000000001111111111111001001111111001111111111001111111001000000000000000000000000000000000
00000000000000001000000000001001000000000000000000000000000000001000000000000000000000000000000000
00000000000000001000000000001001000000000000000000000000000000001000000000000000000000000000000000
00000000000000001001111111001001111111111001111111111001111111111000000000000000000000000000000000
00000000000000001001000001001000000000001001000000001001000000000000000000000000000000000000000000
00000000000000001001000001001000000000001001000000001001000000000000000000000000000000000000000000
00000000000000001001000001001000000000001001000000001001000000000000000000000000000000000000000000
00000000000000001001000001001000000000001001000000001001000000000000000000000000000000000000000000
00000000000000001001000001001000000000001001000000001001000000000000000000000000000000000000000000
00000000000000001001000001001111111111111001000000001001111100000000000000000000000000000000000000
00000000000000001001000001000000000000000001000000001000000000000000000000000000000000000000000000
00000000000000001001000001000000000000000001000020001000000000000000000000000000000000000000000000
00000000000000001001000001111111001111111001000000001001111100000000000000000000000000000000000000
00000000000000001001000000000001001000001001000000001001000000000000000000000000000000000000000000
00000000000000001001000000000001001000001001000000001001000000000000000000000000000000000000000000
00000000000000001001111111111111001111111001111111111001110000000000000000000000000000000000000000
00000000000000001000000000000000000000000000000000000000000000000000000000000000000000000000000000
00000000000000001000000000000000000000000000000000000000000000000000000000000000000000000000000000
00000000000000001001111001111111111111111111111001111111100000000000000000000000000000000000000000
00000000000000001001001001000000000000000000001001000000000000000000000000000000000000000000000000
00000000000000001001001001000000000000000000001001000000000000000000000000000000000000000000000000
00000000000000001001001001111111111000000000001001000000000000000000000000000000000000000000000000
00000000000000001001001000000000001000000000001001000000000000000000000000000000000000000000000000
00000000000000001001001000000000001000000000001001000000000000000000000000000000000000000000000000
00000000000000001001001111111111001000001111111001111111000000000000000000000000000000000000000000
00000000000000001001000000000001001000001000000000000001000000000000000000000000000000000000000000
00000000000000001001000000000001001000001000000000000001000000000000000000000000000000000000000000
00000000000000001001111111111111001000001001111111111001000000000000000000000000000000000000000000
00000000000000001000000000000000001000001001000000001001000000000000000000000000000000000000000000
00000000000000001000000000000000001000001001000000001001000000000000000000000000000000000000000000
00000000000000001001111111111111001000001001111111111001000000000000000000000000000000000000000000
00000000000000001001000000000001001000001000000000000001000000000000000000000000000000000000000000
00000000000000001001000000000001001000001000000000000001000000000000000000000000000000000000000000
00001111111111111001001111111111001000001001111111111001000000000000000000000000000000000000000000
00001000000000000001001000000000001000001001000000001001000000000000000000000000000000000000000000
00001000000000000001001000000000001000001001000000001001000000000000000000000000000000000000000000
00001001111001111111001001111111111000001001111111111001000000000000000000000000000000000000000000
00001001001001000000001001000000000000001000000000000001000000000000000000000000000000000000000000
00001001001001000000001001000000000000001000000000000001000000000000000000000000000000000000000000
00001001001001111111111001111111111000001111111111111111000001111100000000000000000000000000000000
00001001001000000000000000000000001000000000000000000000000001000000000000000000000000000000000000
00001001001000000000000000000000001000000000000000000000000001000000000000000000000000000000000000
00001001001111111111111111111111001001111111111111111111111001001110000000000000000000000000000000
00001001000000000000000000000001001001000000000000000000001001001000000000000000000000000000000000
00001001000000000000000000000001001001000000000000000000001001001000000000000000000000000000000000
00001001111111111000000001111111001001001111111001111111001001001111111000000001111000000000000000
00001000000000001000000001000000001001001000001001000001001001000000001000000001000000000000000000
00001000000000001000000001000000001001001000001001000001001001000000001000000001000000000000000000
00001001111111001000000001001111001001001111111001111111001001001111001000000001001110000000000000
00001001000001001000000001001001001001000000000000000000001001001001001000000001001000000000000000
00001001000001001000000001001001001001000000000000000000001001001001001000000001001000000000000000
00001001111111001111111111001111001001001111111111111111001001001111001111111111001111000000000000
00001000000000000000000000000000001001001000000000000001001001000000000000000000000000000000000000
00001000000000000000000000000000001001001000000000000001001001000000000000000000000000000000000000
00001111111111111111111111111111001111001111111111111111001111001111111111111111110000000000000000
00000000000000000000000000000001000000000000000000000000000000001000000000000000000000000000000000
00000000000000000000000000000001000000000000000000000000000000001000000000000000000000000000000000
00000000000000000000000000000001111111111111111001111111111111111000000000000000000000000000000000
00000000000000000000000000000000000000000000001001000000000000000000000000000000000000000000000000
00000000000000000000000000000000000000000000001001000000000000000000000000000000000000000000000000
00000000000000000000000000000000000000000000001001000000000000000000000000000000000000000000000000
00000000000000000000000000000000000000000000001001000000000000000000000000000000000000000000000000
00000000000000000000000000000000000000000000001001000000000000000000000000000000000000000000000000
00000000000000000000000000000000000000000000011001100000000000000000000000000000000000000000000000
00000000000000000000000000000000000000000000010000100000000000000000000000000000000000000000000000
00000000000000000000000000000000000000000000010000100000000000000000000000000000000000000000000000
00000000000000000000000000000000000000000000010000100000000000000000000000000000000000000000000000
00000000000000000000000000000000000000000000010000100000000000000000000000000000000000000000000000
00000000000000000000000000000000000000000000011111100000000000000000000000000000000000000000000000
00000000000000000000000000000000000000000000000000000000000000000000000000000000000000000000000000
00000000000000000000000000000000000000000000000000000000000000000000000000000000000000000000000000
00000000000000000000000000000000000000000000000000000000000000000000000000000000000000000000000000